10
10
+-+-+-+-+-+-+-+-+-+-+
|     |   |         |
+-+-+ + + + +-+-+-+ +
|     | |   |       |
+ +-+-+ + +-+-+-+-+-+
| |     | |         |
+ +-+-+ +-+ +-+-+-+ +
|     |         | | |
+-+-+ + +-+-+-+ + + +
| |   | |     |   | |
+ + +-+-+ +-+ + +-+ +
| |   |   |   | |   |
+ +-+ + +-+ +-+ + + +
|   | |   |   | | | |
+ + + +-+ +-+ + + + +
| | |     |   | | | |
+ + +-+-+-+ +-+-+ + +
| | |     |   |   | |
+ +-+ +-+ +-+ + +-+ +
|       |       |   |
+-+-+-+-+-+-+-+-+-+-+